xxxxxxxxxxxxx
xb b b b b bx
xb b bcb b bx
xb b b b b bx
xb b     b bx
x           x
c bb b b bb c
x    bbb    x
xb b b b b bx
xb b b b b bx
xb b     b bx
xb b bbb b bx
xxxxxbxbxxxxx
